00 00 00 00 00 00 00 00 00 00 00 00 00 00 00 00 00 00 31 31
00 00 00 00 00 00 00 00 00 00 00 00 00 00 00 00 00 00 00 31
00 00 00 00 31 00 00 00 00 00 00 00 00 00 00 00 00 00 00 31
00 00 00 00 00 00 00 00 00 00 00 00 00 00 00 00 00 00 00 00
00 00 00 00 00 00 00 00 00 00 00 31 31 00 00 00 00 00 00 00
00 00 00 00 00 00 00 00 00 00 00 31 00 00 00 00 00 00 00 00
00 00 00 00 00 00 00 00 00 00 00 00 00 00 00 00 00 00 00 00
00 00 00 00 00 00 00 00 00 00 00 00 00 00 00 00 00 00 00 00
13 13 13 13 13 13 13 13 13 13 13 13 13 13 13 13 13 13 13 13
03 03 03 03 03 03 03 03 03 03 03 03 03 03 03 03 03 03 03 03
14 14 14 14 14 14 14 14 14 14 14 14 14 14 14 14 14 14 14 14
01 01 01 01 01 01 01 01 01 01 01 01 01 01 01 01 01 01 01 01
01 01 01 01 01 01 01 01 01 01 01 01 01 01 01 01 01 01 01 01

