31 31 31 31 31 00 00 00 00 00 00 00 00 00 31 31 31 31 31 31
31 31 31 00 00 00 00 00 00 00 00 00 00 00 00 00 31 31 31 31
31 00 00 00 00 00 00 00 00 00 00 00 00 00 00 00 31 31 31 31
00 00 00 00 00 00 00 00 00 00 00 00 00 00 00 00 00 31 31 31
00 00 00 00 00 00 00 00 00 00 00 00 00 00 00 00 00 31 31 31
00 00 00 00 00 00 00 00 00 00 00 00 00 00 00 00 00 00 31 31
00 00 00 00 00 00 00 00 00 00 00 00 00 00 00 00 00 00 31 31
00 00 00 00 00 00 00 00 00 00 00 00 00 00 00 00 00 00 00 31
13 13 13 13 13 13 13 13 13 13 13 13 13 13 13 13 13 13 13 36
03 03 03 03 03 03 03 03 03 03 03 03 03 03 03 03 03 03 03 21
14 14 14 14 14 14 14 14 14 14 14 14 14 14 14 14 14 14 14 35
01 01 01 01 01 01 01 01 01 01 01 01 01 01 01 01 01 01 01 01
01 01 01 01 01 01 01 01 01 01 01 01 01 01 01 01 01 01 01 01


