31 31 31 31 31 31 31 31 31 31 31 31 31 31 31 31 31 31 31 31
00 00 00 00 00 00 00 00 00 00 00 00 00 31 31 31 31 31 31 31
00 00 00 00 00 00 00 00 00 00 00 00 00 00 31 31 31 31 31 31
00 00 00 00 00 00 00 00 00 00 00 00 00 00 00 00 31 31 31 31
00 00 00 00 00 00 00 00 00 00 00 00 00 00 00 00 00 31 31 31
00 00 00 00 00 00 00 00 00 00 00 00 00 00 00 00 00 00 31 31
00 00 00 00 00 00 00 00 00 00 00 00 00 31 31 00 00 00 31 31
00 00 00 00 31 31 00 00 00 00 00 00 31 00 00 00 00 00 00 31
00 00 00 31 31 31 31 00 00 00 00 00 00 00 00 00 00 00 00 31
00 00 00 00 31 31 00 00 00 00 00 00 00 00 00 00 00 00 31 31
00 00 00 00 31 00 00 00 00 00 00 00 00 00 00 00 00 31 31 31
00 00 00 00 00 00 00 00 00 00 00 00 00 00 00 00 00 00 31 31
00 00 00 00 00 00 00 00 00 00 00 00 00 00 00 00 00 00 00 31
