01 01 01 01 01 04 03 03 03 05 00 00 00 00 00 00 00 00 00 00
01 01 01 01 01 04 03 03 03 05 00 00 00 00 00 00 00 00 00 00
01 01 01 01 01 04 03 03 03 05 00 00 00 00 00 00 00 00 00 00
01 01 01 01 01 04 03 03 03 05 00 00 00 00 00 00 00 00 00 00
01 01 01 01 01 04 03 03 03 05 00 00 00 31 00 00 00 00 00 00
01 01 01 01 01 04 03 03 03 05 00 00 00 00 00 00 00 00 00 00
01 01 01 01 01 04 03 03 03 05 00 00 00 00 00 00 00 00 00 00
01 01 01 01 01 04 03 03 03 05 00 00 00 00 00 00 00 00 00 00
01 01 01 01 01 04 03 03 03 17 13 13 13 13 13 13 13 13 13 13
01 01 01 01 01 04 03 03 03 03 03 03 03 03 03 03 03 03 03 03
01 01 01 01 01 06 14 14 14 14 14 14 14 14 14 14 14 14 14 14
01 01 01 01 01 01 01 01 01 01 01 01 01 01 01 01 01 01 01 01
01 01 01 01 01 01 01 01 01 01 01 01 01 01 01 01 01 01 01 01
